4 13 31
###############################
#p*          2                #
# * ************************* #
# * *      3 2              * #
# * * ********************* * # 
# * * *3* * *2*x* * * * * * * #
# * * ******************* * * #
# * *        2     3      * * #
# * *********************** * #
# *          2              * #
# *************************** #
#            2                #
###############################