3 13 31
###############################
#p                            #
# #*#*#*#*#*# #b# #*#*#*#*#*# #
# *    4    * *b* *   4     * #
# #*#*#*#*#*# #b# #*#*#*#*#*# #
#             *b*             #
# #*#*#*#*#*#*#x#*#*#*#*#*#*# #
#             *f*             #
# #*#*#*#*#*# #f# #*#*#*#*#*# #
# *    4    * *f* *    4    * #
# #*#*#*#*#*# #f# #*#*#*#*#*# #
#                             #
###############################