2 13 31
###############################
#p                            #
# #*# #*#   #*#*#*#   #*#*#*# #
# * * * *   *  2  *   *     * #
# # # # #   # #*#*#   #*# #*# #
# * * * *   * *         * *   #
# # # # #   #1#x#*#     #2#   #
# *2* * *   * *         * *   #
# # #*# #   # #*#*#     # #   #
# *  1  *   *  2  *     * *   #
# #*#b#*#   #*#s#*#     #f#   #
#                             #
###############################