5 13 31
###############################
#p             *              #
# #*#*#*#*#*#*# #*#*#*#*#*#*# #
# *          *   *          * #
# # # #1# # # # # #*#*#*#*#2# #
# *        *       *        * #
# #*#*#*#*# # #x# # #*#*#*#*# #
# **********   5   ** * * * * #
# #*#*#3#*#*# # # # # #4# # # #
# ************   ** * * * * * #
# #*#*#*#*#*#*# #*#*#*#*#*#*# #
#              *              #
###############################